###    ######    ###
###      ##      ###
##     ##  ##     ##
#      ##  ##      #
##                ##
#####   #      #####
###### ##  ### #####
 ##    ######     # 
     ########       
    ############    
    ############    
     ########      #
 #     ######     ##
###### ##  ## ######
#####          #####
##                ##
#   ## #    #  #   #
##   ##      ##   ##
###    #    #    ###
###    ######    ###